. . . . . . . . . . . . . . . . . . . . . # # . . . . . . . 
. . . . . # . . . . . . . . . . . . . . . # # . . . . . . . 
. . . . . . . . . . . # . . . . . . . . . # # . . . . . . . 
. . . # # . . . . # . # . . . . . . . . . # # . # # # # # .
. . . # # . . . . . . # . # # . . . . . . # # . . . . # . .
. . . # # . . # . . . # # # # . . # . . . # # # # # . # . .
. . . # # . . . . . . . . # # . . . # # # # # # # # . # # .
. . . # # . . . . . . . . # # . . . . . . . . . . . . # . .
. . . # # . . . . . . . . # # . . # # # . . . . . . . # . .
. . . # # . . . # # . . . # # . . . . . . . . . # # # # . #
. . . # # . . . # # . . . # # . . . . # . . . . # # . . . .
. . . # # . . . # # . . . # # # . . . # . . . . . # . . . .
. . . . . . . . . . . . . # # . . . . # . . . . . # . . . .
. . . . . . . . . . . . . # . . . . . . . . . . . # . . . .
. . . . . . . . . . . . . # # . . . . # . . . . . # . . . .