. . . . . . . .
. . . . . . . .
. . . # # # . .
. . . # . # . .
. . . # # # . .